SeqID	crossvalidated_tax
Acetitomaculum_Species_FJ834031;tax=d_Bacteria,p_Firmicutes,c_Clostridia,o_Clostridiales,f_Lachnospiraceae,g_Acetitomaculum,s_Acetitomaculum_Species;	Bacteria;Firmicutes;Clostridia;Clostridiales;Lachnospiraceae;Acetitomaculum;Acetitomaculum_Species
Bacillus_Species_FJ380150;tax=d_Bacteria,p_Firmicutes,c_Bacilli,o_Bacillales,f_Bacillaceae,g_Bacillus,s_Bacillus_Species;	Bacteria;Firmicutes;Bacilli;Bacillales;Bacillaceae;Bacillus;Bacillus_Species
Bacillus_galactosidilyticus_AJ535638_TS;tax=d_Bacteria,p_Firmicutes,c_Bacilli,o_Bacillales,f_Bacillaceae,g_Bacillus,s_Bacillus_galactosidilyticus;	Bacteria;Firmicutes;Bacilli;Bacillales;Bacillaceae;Bacillus;[amb]Bacillus galactosidilyticus
Brachybacterium_alimentarium_X91031_TS;tax=d_Bacteria,p_Actinobacteria,c_Actinobacteria,o_Micrococcales,f_Dermabacteraceae,g_Brachybacterium,s_Brachybacterium_alimentarium;	Bacteria;Actinobacteria;Actinobacteria;Micrococcales;Dermabacteraceae;Brachybacterium;[amb]Brachybacterium alimentarium
Desulfomonile_limimaris_JQ770032;tax=d_Bacteria,p_Proteobacteria,c_Deltaproteobacteria,o_Syntrophobacterales,f_Syntrophaceae,g_Desulfomonile,s_Desulfomonile_limimaris;	Bacteria;Proteobacteria;Deltaproteobacteria;Syntrophobacterales;Syntrophaceae;Desulfomonile;Desulfomonile limimaris
Draconibacterium_Species_AY570569;tax=d_Bacteria,p_Bacteroidetes,c_Bacteroidia,o_Bacteroidales,f_Prolixibacteraceae,g_Draconibacterium,s_Draconibacterium_Species;	Bacteria;Bacteroidetes;Bacteroidia;Bacteroidales;Prolixibacteraceae;Draconibacterium;Draconibacterium_Species
Finegoldia_magna_KC333937;tax=d_Bacteria,p_Firmicutes,c_Clostridia,o_Clostridiales,f_Peptoniphilaceae,g_Finegoldia,s_Finegoldia_magna;	Bacteria;Firmicutes;Clostridia;Clostridiales;Peptoniphilaceae;Finegoldia;Finegoldia magna
Gilvimarinus_polysaccharolyticus_AACY023784545;tax=d_Bacteria,p_Proteobacteria,c_Gammaproteobacteria,o_Cellvibrionales,f_Cellvibrionaceae,g_Gilvimarinus,s_Gilvimarinus_polysaccharolyticus;	Bacteria;Proteobacteria;Gammaproteobacteria;Cellvibrionales;Cellvibrionaceae;Gilvimarinus;Gilvimarinus polysaccharolyticus
Haliangium_tepidum_AJ233944_TS;tax=d_Bacteria,p_Proteobacteria,c_Deltaproteobacteria,o_Myxococcales,f_Haliangiaceae,g_Haliangium,s_Haliangium_tepidum;	Bacteria;Proteobacteria;Deltaproteobacteria;Myxococcales;Haliangiaceae;Haliangium;Haliangium tepidum
Klebsiella_Species_A4_KC434961;tax=d_Bacteria,p_Proteobacteria,c_Gammaproteobacteria,o_Enterobacteriales,f_Enterobacteriaceae,g_Klebsiella,s_Klebsiella_Species_A4;	Bacteria;Proteobacteria;Gammaproteobacteria;Enterobacteriales;Enterobacteriaceae;Klebsiella;Klebsiella_Species_A4
Kocuria_kristinae_X80749_TS;tax=d_Bacteria,p_Actinobacteria,c_Actinobacteria,o_Micrococcales,f_Micrococcaceae,g_Kocuria,s_Kocuria_kristinae;	Bacteria;Actinobacteria;Actinobacteria;Micrococcales;Micrococcaceae;Kocuria;Kocuria kristinae
Lactobacillus_agilis_AB596945_TS;tax=d_Bacteria,p_Firmicutes,c_Bacilli,o_Lactobacillales,f_Lactobacillaceae,g_Lactobacillus,s_Lactobacillus_agilis;	Bacteria;Firmicutes;Bacilli;Lactobacillales;Lactobacillaceae;Lactobacillus;Lactobacillus agilis
Lactobacillus_algidus_AB033209_TS;tax=d_Bacteria,p_Firmicutes,c_Bacilli,o_Lactobacillales,f_Lactobacillaceae,g_Lactobacillus,s_Lactobacillus_algidus;	Bacteria;Firmicutes;Bacilli;Lactobacillales;Lactobacillaceae;Lactobacillus;Lactobacillus algidus
Lactobacillus_alimentarius_M58804_TS;tax=d_Bacteria,p_Firmicutes,c_Bacilli,o_Lactobacillales,f_Lactobacillaceae,g_Lactobacillus,s_Lactobacillus_alimentarius;	Bacteria;Firmicutes;Bacilli;Lactobacillales;Lactobacillaceae;Lactobacillus;[amb]Lactobacillus alimentarius
Lactobacillus_amylolyticus_FR683095_TS;tax=d_Bacteria,p_Firmicutes,c_Bacilli,o_Lactobacillales,f_Lactobacillaceae,g_Lactobacillus,s_Lactobacillus_amylolyticus;	Bacteria;Firmicutes;Bacilli;Lactobacillales;Lactobacillaceae;Lactobacillus;[amb]Lactobacillus amylolyticus
Lactobacillus_amylophilus_AB680988_TS;tax=d_Bacteria,p_Firmicutes,c_Bacilli,o_Lactobacillales,f_Lactobacillaceae,g_Lactobacillus,s_Lactobacillus_amylophilus;	Bacteria;Firmicutes;Bacilli;Lactobacillales;Lactobacillaceae;Lactobacillus;Lactobacillus amylophilus
Leptotrichia_goodfellowii_JQ467377;tax=d_Bacteria,p_Fusobacteria,c_Fusobacteriia,o_Fusobacteriales,f_Leptotrichiaceae,g_Leptotrichia,s_Leptotrichia_goodfellowii;	Bacteria;Fusobacteria;Fusobacteriia;Fusobacteriales;Leptotrichiaceae;Leptotrichia;Leptotrichia goodfellowii
Leucobacter_luti_AM072819_TS;tax=d_Bacteria,p_Actinobacteria,c_Actinobacteria,o_Micrococcales,f_Microbacteriaceae,g_Leucobacter,s_Leucobacter_luti;	Bacteria;Actinobacteria;Actinobacteria;Micrococcales;Microbacteriaceae;[amb]Leucobacter;[amb]Leucobacter luti
Microvirga_aerophila_JX133402;tax=d_Bacteria,p_Proteobacteria,c_Alphaproteobacteria,o_Rhizobiales,f_Methylobacteriaceae,g_Microvirga,s_Microvirga_aerophila;	Bacteria;Proteobacteria;Alphaproteobacteria;Rhizobiales;Methylobacteriaceae;Microvirga;Microvirga aerophila
Novosphingobium_sediminicola_FJ177534_TS;tax=d_Bacteria,p_Proteobacteria,c_Alphaproteobacteria,o_Sphingomonadales,f_Sphingomonadaceae,g_Novosphingobium,s_Novosphingobium_sediminicola;	Bacteria;Proteobacteria;Alphaproteobacteria;Sphingomonadales;Sphingomonadaceae;Novosphingobium;Novosphingobium sediminicola
Odoribacter_laneus_AB606328;tax=d_Bacteria,p_Bacteroidetes,c_Bacteroidia,o_Bacteroidales,f_Porphyromonadaceae,g_Odoribacter,s_Odoribacter_laneus;	Bacteria;Bacteroidetes;Bacteroidia;Bacteroidales;Porphyromonadaceae;Odoribacter;Odoribacter laneus
Oscillibacter_valericigenes_EU461403;tax=d_Bacteria,p_Firmicutes,c_Clostridia,o_Clostridiales,f_Ruminococcaceae,g_Oscillibacter,s_Oscillibacter_valericigenes;	Bacteria;Firmicutes;Clostridia;Clostridiales;Ruminococcaceae;Oscillibacter;Oscillibacter valericigenes
Paenibacillus_camelliae_EU400621_TS;tax=d_Bacteria,p_Firmicutes,c_Bacilli,o_Bacillales,f_Paenibacillaceae,g_Paenibacillus,s_Paenibacillus_camelliae;	Bacteria;Firmicutes;Bacilli;Bacillales;Paenibacillaceae;Paenibacillus;Paenibacillus camelliae
Paludibacter_propionicigenes_AB744102;tax=d_Bacteria,p_Bacteroidetes,c_Bacteroidia,o_Bacteroidales,f_Porphyromonadaceae,g_Paludibacter,s_Paludibacter_propionicigenes;	Bacteria;Bacteroidetes;Bacteroidia;Bacteroidales;Porphyromonadaceae;Paludibacter;Paludibacter propionicigenes
Pseudomonas_extremorientalis_AF405328_TS;tax=d_Bacteria,p_Proteobacteria,c_Gammaproteobacteria,o_Pseudomonadales,f_Pseudomonadaceae,g_Pseudomonas,s_Pseudomonas_extremorientalis;	Bacteria;Proteobacteria;Gammaproteobacteria;Pseudomonadales;Pseudomonadaceae;Pseudomonas;[amb]Pseudomonas extremorientalis
Psychrobacter_Species_AY007244;tax=d_Bacteria,p_Proteobacteria,c_Gammaproteobacteria,o_Pseudomonadales,f_Moraxellaceae,g_Psychrobacter,s_Psychrobacter_Species;	Bacteria;Proteobacteria;Gammaproteobacteria;Pseudomonadales;Moraxellaceae;Psychrobacter;[amb]Psychrobacter_Species
Reyranella_massiliensis_EF394922_TS;tax=d_Bacteria,p_Proteobacteria,c_Alphaproteobacteria,o_Rhodospirillales,f_Rhodospirillaceae,g_Reyranella,s_Reyranella_massiliensis;	Bacteria;Proteobacteria;Alphaproteobacteria;Rhodospirillales;Rhodospirillaceae;Reyranella;Reyranella massiliensis
Ruminobacter_amylophilus_Y15992_TS;tax=d_Bacteria,p_Proteobacteria,c_Gammaproteobacteria,o_Aeromonadales,f_Succinivibrionaceae,g_Ruminobacter,s_Ruminobacter_amylophilus;	Bacteria;Proteobacteria;Gammaproteobacteria;Aeromonadales;Succinivibrionaceae;Ruminobacter;Ruminobacter amylophilus
Saccharofermentans_acetigenes_DQ206423;tax=d_Bacteria,p_Firmicutes,c_Clostridia,o_Clostridiales,f_Ruminococcaceae,g_Saccharofermentans,s_Saccharofermentans_acetigenes;	Bacteria;Firmicutes;Clostridia;Clostridiales;Ruminococcaceae;Saccharofermentans;Saccharofermentans acetigenes
Slackia_heliotrinireducens_AF101241_TS;tax=d_Bacteria,p_Actinobacteria,c_Coriobacteriia,o_Coriobacteriales,f_Coriobacteriaceae,g_Slackia,s_Slackia_heliotrinireducens;	Bacteria;Actinobacteria;Coriobacteriia;Coriobacteriales;Coriobacteriaceae;Slackia;Slackia heliotrinireducens
Stackebrandtia_albiflava_DQ985165_TS;tax=d_Bacteria,p_Actinobacteria,c_Actinobacteria,o_Micromonosporales,f_Micromonosporaceae,g_Stackebrandtia,s_Stackebrandtia_albiflava;	Bacteria;Actinobacteria;Actinobacteria;Micromonosporales;Micromonosporaceae;Stackebrandtia;Stackebrandtia albiflava
Stackebrandtia_nassauensis_AM982657;tax=d_Bacteria,p_Actinobacteria,c_Actinobacteria,o_Micromonosporales,f_Micromonosporaceae,g_Stackebrandtia,s_Stackebrandtia_nassauensis;	Bacteria;Actinobacteria;Actinobacteria;Micromonosporales;Micromonosporaceae;Stackebrandtia;Stackebrandtia nassauensis
Stackebrandtia_nassauensis_AY650268_TS;tax=d_Bacteria,p_Actinobacteria,c_Actinobacteria,o_Micromonosporales,f_Micromonosporaceae,g_Stackebrandtia,s_Stackebrandtia_nassauensis;	Bacteria;Actinobacteria;Actinobacteria;Micromonosporales;Micromonosporaceae;Stackebrandtia;Stackebrandtia nassauensis
Stackebrandtia_nassauensis_JF155032;tax=d_Bacteria,p_Actinobacteria,c_Actinobacteria,o_Micromonosporales,f_Micromonosporaceae,g_Stackebrandtia,s_Stackebrandtia_nassauensis;	Bacteria;Actinobacteria;Actinobacteria;Micromonosporales;Micromonosporaceae;Stackebrandtia;Stackebrandtia nassauensis
Staphylococcus_agnetis_HM484980_TS;tax=d_Bacteria,p_Firmicutes,c_Bacilli,o_Bacillales,f_Staphylococcaceae,g_Staphylococcus,s_Staphylococcus_agnetis;	Bacteria;Firmicutes;Bacilli;Bacillales;Staphylococcaceae;Staphylococcus;[amb]Staphylococcus agnetis
Staphylococcus_arlettae_AB009933_TS;tax=d_Bacteria,p_Firmicutes,c_Bacilli,o_Bacillales,f_Staphylococcaceae,g_Staphylococcus,s_Staphylococcus_arlettae;	Bacteria;Firmicutes;Bacilli;Bacillales;Staphylococcaceae;Staphylococcus;[amb]Staphylococcus arlettae
Staphylococcus_aureus_AM990992;tax=d_Bacteria,p_Firmicutes,c_Bacilli,o_Bacillales,f_Staphylococcaceae,g_Staphylococcus,s_Staphylococcus_aureus;	Bacteria;Firmicutes;Bacilli;Bacillales;Staphylococcaceae;Staphylococcus;[amb]Staphylococcus aureus
Streptobacillus_hongkongensis_HM255715;tax=d_Bacteria,p_Fusobacteria,c_Fusobacteriia,o_Fusobacteriales,f_Leptotrichiaceae,g_Streptobacillus,s_Streptobacillus_hongkongensis;	Bacteria;Fusobacteria;Fusobacteriia;Fusobacteriales;Leptotrichiaceae;Streptobacillus;Streptobacillus hongkongensis
Streptobacillus_hongkongensis_JQ087389_TS;tax=d_Bacteria,p_Fusobacteria,c_Fusobacteriia,o_Fusobacteriales,f_Leptotrichiaceae,g_Streptobacillus,s_Streptobacillus_hongkongensis;	Bacteria;Fusobacteria;Fusobacteriia;Fusobacteriales;Leptotrichiaceae;Streptobacillus;Streptobacillus hongkongensis
Streptobacillus_moniliformis_CP001779_TS;tax=d_Bacteria,p_Fusobacteria,c_Fusobacteriia,o_Fusobacteriales,f_Leptotrichiaceae,g_Streptobacillus,s_Streptobacillus_moniliformis;	Bacteria;Fusobacteria;Fusobacteriia;Fusobacteriales;Leptotrichiaceae;Streptobacillus;Streptobacillus moniliformis
Streptococcus_agalactiae_AB002479_TS;tax=d_Bacteria,p_Firmicutes,c_Bacilli,o_Lactobacillales,f_Streptococcaceae,g_Streptococcus,s_Streptococcus_agalactiae;	Bacteria;Firmicutes;Bacilli;Lactobacillales;Streptococcaceae;Streptococcus;Streptococcus agalactiae
Streptococcus_agalactiae_AM157422;tax=d_Bacteria,p_Firmicutes,c_Bacilli,o_Lactobacillales,f_Streptococcaceae,g_Streptococcus,s_Streptococcus_agalactiae;	Bacteria;Firmicutes;Bacilli;Lactobacillales;Streptococcaceae;Streptococcus;Streptococcus agalactiae
Streptococcus_agalactiae_JQ389895;tax=d_Bacteria,p_Firmicutes,c_Bacilli,o_Lactobacillales,f_Streptococcaceae,g_Streptococcus,s_Streptococcus_agalactiae;	Bacteria;Firmicutes;Bacilli;Lactobacillales;Streptococcaceae;Streptococcus;Streptococcus agalactiae
Streptococcus_alactolyticus_AF201899_TS;tax=d_Bacteria,p_Firmicutes,c_Bacilli,o_Lactobacillales,f_Streptococcaceae,g_Streptococcus,s_Streptococcus_alactolyticus;	Bacteria;Firmicutes;Bacilli;Lactobacillales;Streptococcaceae;Streptococcus;[amb]Streptococcus alactolyticus
Streptococcus_anginosus_AB355609_TS;tax=d_Bacteria,p_Firmicutes,c_Bacilli,o_Lactobacillales,f_Streptococcaceae,g_Streptococcus,s_Streptococcus_anginosus;	Bacteria;Firmicutes;Bacilli;Lactobacillales;Streptococcaceae;Streptococcus;[amb]Streptococcus anginosus
Suttonella_indologenes_M35015_TS;tax=d_Bacteria,p_Proteobacteria,c_Gammaproteobacteria,o_Cardiobacteriales,f_Cardiobacteriaceae,g_Suttonella,s_Suttonella_indologenes;	Bacteria;Proteobacteria;Gammaproteobacteria;Cardiobacteriales;Cardiobacteriaceae;Suttonella;Suttonella indologenes
Virgibacillus_proomii_AJ012667_TS;tax=d_Bacteria,p_Firmicutes,c_Bacilli,o_Bacillales,f_Bacillaceae,g_Virgibacillus,s_Virgibacillus_proomii;	Bacteria;Firmicutes;Bacilli;Bacillales;Bacillaceae;Virgibacillus;Virgibacillus proomii
Winogradskyella_Species_JQ083322;tax=d_Bacteria,p_Bacteroidetes,c_Flavobacteriia,o_Flavobacteriales,f_Flavobacteriaceae,g_Winogradskyella,s_Winogradskyella_Species;	Bacteria;Bacteroidetes;Flavobacteriia;Flavobacteriales;Flavobacteriaceae;[amb]Winogradskyella;[amb]Winogradskyella_Species
Yeosuana_aromativorans_AY682382_TS;tax=d_Bacteria,p_Bacteroidetes,c_Flavobacteriia,o_Flavobacteriales,f_Flavobacteriaceae,g_Yeosuana,s_Yeosuana_aromativorans;	Bacteria;Bacteroidetes;Flavobacteriia;Flavobacteriales;Flavobacteriaceae;Yeosuana;Yeosuana aromativorans
[Eubacterium]_sulci_HE681354;tax=d_Bacteria,p_Firmicutes,c_Clostridia,o_Clostridiales,f_Clostridiales_Family_XIII,g_[Eubacterium]_nodatum_group,s_[Eubacterium]_sulci;	Bacteria;Firmicutes;Clostridia;Clostridiales;Clostridiales_Family_XIII;[Eubacterium] nodatum group;[Eubacterium] sulci
